NO xpm/booba.xpm
SO xpm/booba.xpm
WE xpm/booba.xpm
EA xpm/booba.xpm

F 62,134,81
C 93,176,212

111111111111111111111
1000000000000000000E1
111111111111111111111
