NO xpm/booba.xpm
SO xpm/booba.xpm
WE xpm/booba.xpm
EA xpm/booba.xpm

F 62,134,81
C 93,176,212

111111111111
1          1
1          1
111111111111
1S0000000001
111111111111
1         1
111111111111
