NO xpm/textu   res3/t ext00.xpm           
SO xpm/textures3/text01.xpm    
WE xpm/textures3/text02.xpm         
EA       xpm/textures3/text03.xpm

F            62,  134, 81        
C  93  ,17 6,  21 2

   1111111111111111111111111         
   1000000000001000000000001
  10000000000000001000000001      
 100000000000000000000000111
100000D00000000000D0000011111111111111111111111111
 10000000000010001111100000000000000000000001
  1000000000000001 100000111111111111111111111
   100000000000001111100001
  100000000000000000000001
 1000000000000000S00000001
1111111111111111111111111

