NO xpm/booba.xpm
SO xpm/booba.xpm
WE xpm/booba.xpm
EA xpm/booba.xpm

F 20,20,20
C 200,200,200
111
10001
10001
10001
10001
10001
11001
10001
10001
10001
10001
10001
11111
1N11111

